NO textures/rendu/NORTH.xpm
SO textures/rendu/SOUTH.xpm
WE textures/rendu/WEST.xpm
EA textures/rendu/EAST.xpm

C 153,204,25
F 20,20,20

1111111111111111111111
100S001000000000100001
1000001000000000D00001
1000001000000000100001
1000001111110000100001
1000000000010000100001
1000000000010000100001
1000000000010000100001
1000000000010000100001
111111111D110000100001
1000000100010000100001
1000000100010000100001
1000000000010000100001
1000000000010000100001
1000000000010000100001
11100000000100001111D1
1111D11111110000100001
1110000000000000100001
1110000000000000100001
1110000000000000100001
1111111111111111111111
