NO textures/matrix.xpm
SO textures/matrix.xpm
WE textures/matrix.xpm
EA textures/matrix.xpm

F 0,0,0
C 0,0,0

111111111111111111111
101000000000000010001
101000000000000010001
101000000000000010001
101000000000000010001
1010000000000000100001
101000000000000010001
101000000000000010001
101000000000000010001
101000000000000010001
101000000000000010001
101000000000000010001
101000000   0000010001111
101000000000000010000
1010000000000000100011111
101000000000000010001
101000000000000010001
101000000000000010001
101000000000000010001
101000000000000010001
101000000000000010001
101000000000000010001
101000000000000010001
101000000000000010001
101000000000000010001
101000000000000010001
10100000100N000000001
111111111111111111111